NO ./textures/8/north.xpm
SO ./textures/8/south.xpm
WE ./textures/8/west.xpm
EA ./textures/8/east.xpm

F 180,211,180
C 135,206,235

        1111111111111111111111111
        1000000000110000000F00F01
        101100F00111000F0S0000F01
        1001000000000000000F00001
111111111011000001110000000000001
100F00000011000001110111111111111
11110111111111011100000010001
11110111111111011101010010F01
11000000110101011100000010001
100F00KKKKKKKKK011000F00C00K1
100F0000KKKK00001101010010001
1100000111010101111101111000111
11010111 1110101 1011110100F1
11011111 1111111 1111111111111
110111111111111111111111111111
1000CCCCCCCCCCCCCCCCCCCCCCCCK1
111111111111111111111111111111
