NO ./textures/8/north.xpm
SO ./textures/8/south.xpm
WE ./textures/8/west.xpm
EA ./textures/8/east.xpm

F 100,100,100
C 135,206,235

11111111111111111111111111111111111111111111111111111111111
100000000011111111000000K10011111K1000000000000000000000001
100111111000000000000000K1000000001011111111111111111111101
1011111111111111111111111101111111100100000000001111000K101
10000000000000000000000000000000000010000111000000000000101
10111111111111111111111111111111111100000100101111111111101
10000000000000000000000000000000000000111100100000000000001
11111111111111111111111111111101111111001010101111111111111
10000000000000000000000000000001K100000000001000000000000K1
10111111111111111111111111111111010111111111101111111111111
10000000000000000000000000000000000100000000000000000000001
11111111111111111111111101111111110101111111111111111111101
10000000000000000000000001000001K101K1K00000000001000000101
10111111111111111111111111011101011111111111110000010000101
1000000000000000000000000100E1000000F000001K001111111100101
11111111111111111111111101111100111111110010000000000000101
10000000000000000000000000010001000010000111111111111110101
1011111111111111111111111111K110010000100000000000000000101
10000000000000000000000000011111111111110111000000000000101
11111111111111111111111111010000010000010100011111111111101
100000000000000000000000000101100100100101011K0000000000001
10111111111111111011111111110010010111010010011111111111101
100000000000000000000000000001000001000K101000100010001K101
1111111111111111111111K111111111111111111000000010001000101
1KKKKK10000101000100010100100100100010010101111111111111101
1KKKKK10010000010000010000000000000000000100000000000000001
1KKKKK11111111111111111111111111111111110101111111111111101
1KKKKK00000000000000000000000000000000000101K00000000000001
11111111111111111111111111111111111111111111111111111111111
