NO ./textures/1/north.xpm
SO ./textures/1/south.xpm
WE ./textures/1/west.xpm
EA ./textures/1/east.xpm

F 100,100,100
C 0,0,0

11111111111111111
10000000011111111
10100010011111111
10000001010000001
1000E000011111101
10000000000000001
10010000011111001
10000000000000001
10000000011111101
10000001011111111
10000000000000001
11111111111111111