NO ./textures/north.xpm
SO ./textures/south.xpm
WE ./textures/west.xpm
EA ./textures/east.xpm

F 100,100,100
C 135,206,235

1111111111
1000000001
1010001001
1000000001
1000N00001
1000000001
1000001001
1011000001
1000000001
1111111111