NO ./textures/8/north.xpm
SO ./textures/8/south.xpm
WE ./textures/8/west.xpm
EA ./textures/8/east.xpm

F 180,211,180
C 135,206,235

11111111111111111111111111111111111111111111111111111111111111111111111111111111
10000000001110000000000000000001111111000000000000000000000000000000000000000001
10000000001110000001111111110001100001000000001111111110000000000000000000000001
1000F000001110000001100000010001100001000F00001100000010000000000000000000000001
1000000000111000000110000001000110000100000000110000001000K0000000000000000000001
1000K000001111111111111111110001111111000000001111111110000000000000000000000001
10000000000000000000000000000000000000000000000000000000000000000000000000000001
1111111111111111111111111111111C111111111111111111111111111111111111111111111111
10000000001111000000000000000000110000000000000000000000000000000000000000000001
1000F000001110000011111111110001110000011111110000000011111111100000000000000001
100000000011100000011000001110000C0F0000110000100000000110000001000K000000000001
1000K000001110000011000000010011100000011000010000000011000000100000000000000001
10000000001111111111111111111001111111111111111100000001111111110000000000000001
10000000000000000000000000000000000000000000000000000000000000000000000000000001
1111111111111111111111111111111C111111111111111111111111111111111111111111111111
10000000001111100000000000000000111000000000000000000000000000000000000000000001
1000F0000011110000111111111100011110000111111100000000111111111000F0000000000001
1000K00000111000001100000111000C000F00011000010000000011000001000000000000000001
1000000000111000000110000001000111100000110000100000000110000010000K000000000001
10000000001111111111111111110001111111111111111100000001111111110000000000000001
10000000000000000000000000000000000000000000000000000000000000000000000000000001
1111111111111111111111111111111C111111111111111111111111111111111111111111111111
10000000001111110000000000000000111100000000000000000000000000000000000000000001
1000F0000011111000111111111100111111000111111100000000111111111000F0000000000001
1000K0000011100000110000011100CCCCCF0001100001000K000011000001000000000000000001
100000000011100000011000000100011111000011000010000000011000001000000000000000001
1000F000001111111111111111110011111111111111111000000011111111100000000000000001
10000000000000000000000000000000000000000000000000000000000000000000000000000001
1111111111111111111111111111111C111111111111111111111111111111111111111111111111
10000000001111111000000000000000111110000000000000000000000000000000000000000001
1000F0000011111100111111111100111111100111111100000000111111111000F0000000000001
1000K0000011100000110000011100CCCCCCF0011000010000K0000110000010000F000000000001
100000000011100000011000000100011111100011000010000000011000001000000000000000001
1000F0000011111111111111111100111111111111111110000000111111111000K0000000000001
10000000000000000000000000000000000000000000000000000000000000000000000000000001
1111111111111111111111111111111C111111111111111111111111111111111111111111111111
10000000001111111000000000000000111111000000000000000000000000000000000000000001
1000F000001111111C111111111100111111100111111100000000111111111000F0000000000001
1000K0000011100000110000011100CCCCCCF0011000010000K0000110000010000F000000000001
10000000000000000011000000CF0011111100011000010000000011000001000000000000000001
1000F0000011111111111111111100111111111111111110000000111111111000K0000000000S001
11111111111111111111111111111111111111111111111111111111111111111111111111111111